#######################
#P                   C#
#                     #
#                     #
#                     #
#                     #
#                     #
#           W         #
#                     #
#                     #
#                     #
#                     #
#######################