#######################
#D#D D#   D  W     B X#
# #  B  # D####D#D## ##
#P D  ####H#0 0D#H##W##
# #  B  ##B####B#B## ##
#D#D D# #     B      X#
#######B## ############
#D      #X     BW    B#
# #W###X## # ####### ##
#H#B#X######     B   X#
#B#   B WWW#B#######D##
#X# # B 2 Q#D 1 H 1 D##
#######################