#####################
#P      D           #
#     V       M     #
#       D           #
#     V       S     #
#       D           #
#     V       M     #
#       D           #
#     V       S     #
#       D           #
#     V       M     #
#       D          C#
#####################