#####################
#P#   2        2    #
# #  #######        #
# ####     #        #
#      ##  #  2   2 #
########   #        #
#          #####W####
#                   #
#     ##       ######
#    ##             #
#                ## #
#Q                # #
#####################