#######################
#PDDD      D   D   D#C#
#     DDDD D D   D1D# #
#DD DDDD D D DDDDDDDD #
#   D    D  3D      D #
# DDD D DDD DD DDDD D #
#     D      D    D D #
#DD DDD D DDDD DD D D #
#   D       D   D D D #
# DD  DDDDD D D D D   #
# DDDDD   D D D DDDDD #
#     3 D     D    D  #
#######################