#######################
#######################
#####bb    P    ss#####
#####WWWWWWWWWWWWW#####
#####             #####
##### WWWWW WWWWW #####
##### WWW     WWW #####
#####      #      #####
##### WWW  0  WWW #####
##### WWWWWWWWQWW #####
#####      2      #####
#######################
#######################