#####################
#P      D           #
#     B       3     #
#       D           #
#     B       2     #
#       D           #
#     B       3     #
#       D           #
#     B       2     #
#       D           #
#     B       3     #
#       D          C#
#####################