#######################
#b              33333D#
#P################### #
# B    W        W     #
#   #WWWWWWQWWWWWWWWWW#
#####################W#
#   #1            1## #
# #W#    #         #s #
#W# #          #   ## #
# # #  #           Wb #
# #W#      #       ## #
#W# W1         #  1#s #
#######################