#######################
###P             DWW###
###               bW###
###                D###
###                 ###
###                 ###
###                 ###
###                0###
###               2W###
###D             1Ws###
###Ws           2WWW###
###WWD         0WbWQ###
#######################