#######################
#P                    #
#                     #
#                     #
#                     #
#                     #
#            0        #
#                     #
#                     #
#                     #
#                     #
#                    C#
#######################