#######################
#P#D   D    D    W  Ws#
# #  B   B     BB#W Wb#
# #  BB B    B   ## ###
# # 1     B    B #  B0#
#W#  BBB     B   ## ###
#B#0      W  B   #  B0#
# #         1  WQ## ###
# #D3 WD0   D WWW#  B0#
# ################WW###
#   #   #  B   3      #
# # W # W  B   3 2    #
#######################