#####################
#P#   S        S    #
# #  #######        #
# ####     #        #
#      ##  #  S   S #
########   #        #
#          #####W####
#                   #
#     ##       ######
#    ##             #
#                ## #
#Q                # #
#####################