#######################
# P#WWW     0    1    #
# #####  2    2    2  #
#     #    1    0     #
##### ##############WW#
#WWs#              #  #
#sWW######         ## #
#WWW       #   #   ## #
#WbW      ###      ## #
#QW                   #
#W       ###   WW  ####
#                  W#B#
#######################