#####################
#P     b      W     #
#     W        s    #
#                W  #
#    W  b       W   #
#                   #
#     W      b      #
#         M         #
#    s       W      #
#                   #
#   b    M     s    #
#    W             Q#
#####################