#######################
#P#####     #WQWWWWWWW#
# ##  W ### #  W  WWWW#
# ## #### W #WWWWWWW  #
#    #    ###  W   WW #
###### ####D# W   WWWW#
######W##########W#####
#WW        0  W     W #
# W # # # # # # # #  0#
#   # WWW   W     # WW#
# WW# # # # # # # # W #
#0        W  0  W    1#
#######################