#####################
#P#   1        1    #
# #  #######        #
# ####     #        #
#      ##  #  1   1 #
########   #        #
#          #####W####
#                   #
#     ##       ######
#    ##             #
#                ## #
#Q                # #
#####################