#######################
#######################
#######################
######P          ######
###### #WWWWWW # ######
###### WWWWWWW   ######
###### WWWWCWWWW ######
######   WWWWWWW0######
###### # WWWWWW# ######
######        0  ######
#######################
#######################
#######################