#######################
#Pb    H H     H H H D#
#sHH H H   HsH H      #
# H    H H H H   HHH D#
#   HHsH Hb    H   H  #
# H H   0  HHH H H HHD#
# HHHH HH      0 H  1 #
# H     HHHH HHH HH HD#
# b HHH 0 H  H H H    #
#HH   HHH   HH H   H3D#
# HH H 1  H    HH3HHHH#
#D D D D D D D D D D Q#
#######################