#######################
#######################
#####P            #####
##### WW WW W#W W #####
##### WW WWWWWW   #####
##### W#   0 WWW# #####
##### WW WWW   WW #####
##### WW WWWWW 0  #####
#####    WQWWW#WW #####
##### WW#WWW WW1W #####
#####    0        #####
#######################
#######################