#####################
#P      D           #
#     B       M     #
#       D           #
#     B       S     #
#       D           #
#     B       M     #
#       D           #
#     B       S     #
#       D           #
#     B       M     #
#       D          C#
#####################