#######################
##D P# W1#  B B B  #  #
##D  #B# ##  B B B WBB#
##D  # #DD# B B B  #  #
#D W #C#DD#  B B B ## #
#D DD# #  W B B B  #WD#
#D D################ ##
#D D#D  D#W  B 22 #DBD#
#DBD#   B  #####W##   #
#D D#D  W###  0# s# 0 #
#D      B  ## ## ##   #
## ##D  D#W   b# W  D #
#######################