#######################
######DDDDDWDDDDD######
######D 0     0 D######
######D DDD DDD D######
######D DDD DDD D######
######D DD# #DD D######
######WP   D    W######
######D DD# #DD D######
######D DDD DDD D######
######D DDD DDD D######
######D 0     0 D######
######DDDDDQDDDDD######
#######################