#####################
#P#   0        1    #
# #  #######        #
# ####     #        #
#      ##  #  3   2 #
########   #        #
#          #####W####
#                   #
#     ##       ######
#    ##             #
#                ## #
#Q                # #
#####################