#######################
#W 0    0 #b# 1      Q#
#    0    # #         #
#  0   0  # W     1   #
#0   0   D# #D1       #
####W###### ###########
#s         P         s#
########### ######W####
#        D# #D        #
#      3  W #  2      #
#         # #     2   #
#W        #b#        W#
#######################