#######################
######## ##DDDDDDDDDDD#
# W D  DBC#bbbbbbbbbbb#
#WD   W B #sssssssssss#
#W#####WWW###### ######
#W##### WWWWWWWW   1 D#
#W##D  D   1    D    D#
# ##2WW WWWWWWWWWWWWW #
#W## WW WBBBBBBBBBBBW #
#W##DWWDWWWWWWWWWWWWWD#
# ###################2#
#P D 0      0       0D#
#######################