#####################
#P     b      W     #
#     W        s    #
#                W  #
#    W  b       W   #
#                   #
#     W      b      #
#         0         #
#    s       W      #
#                   #
#   b    0     s    #
#    W             Q#
#####################