#######
#P#   #
#   ###
#     #
#WWWW #
#######