#######################
#P   bDW   WD    WD   #
#W###    #    #W#   # #
#   ##H# # ## # ##H##B#
#DB   X# B X#W#B WB X #
#W##W# W#X#D#D#X##W## #
# Q#B B #B#0#0###W HD #
# W#X#DW   B B   BD##X#
#BW######## # ###X##  #
#   #    DHHHHH  W#  X#
#WH   BWBD#B#B#   HB D#
#X#XXXXWXX#X#X#X##X  X#
#######################