#######################
#Pss                DQ#
#b#     ##D          D#
#b      ##D           #
#                     #
#   ##D           ##  #
#   ##D           ##  #
#          ##D       0#
#          ##D      23#
#      ##          31D#
#D     ##         21DW#
#3D              03DW2#
#######################