#######################
#D 1D#####bP #0#W QWW2#
# ##D D 2## ## #2W WW #
#1#### ####D  D# WWW W#
# #0D#D0 D# ## #W 2W 2#
# ## # ## # ######WWWW#
#D  D# #0D# #1  D# D D#
###### #### #### #D D #
#D0 D#D    D 1  D# D2D#
# ## ###### ######D DD#
# ######### #########D#
#D    2    D    2    D#
#######################