#######################
#  3     3#       3  X#
# #####################
#   3    3#       3  X#
# ######### ###########
#       WD            #
#P             WB     #
# ################### #
# W3W3W3W3W3W1W#      #
# W W W W WHWHW# ######
#  s b s b s bW# ####O#
# W2W2W2W2W2W0W#      #
#######################