#######################
#PWW# 0    0    0    B#
# #Q#  #### ####### Bs#
# ###  #   0   #  0  B#
# Ws#  ###   0 #    Bb#
# ###  #       #  0  B#
#W#WW 0    0    0   Bs#
# # #  # #### ####  0B#
# B # 0# #DD#   0#  Bb#
#B#B#  # #DD# #### 0 B#
# b W  #0#### ####  Bs#
#X#X# 1   1   1   1  B#
#######################