SSSSSSSSSSSSSSSSSSSSSSS
SCSSSSR S  S S  S   SBS
S  SSS  S       S SSS#S
S  BXS      S       SBS
S  SSSSS    SSSS    WWS
S SSSSHHHHHHHHHHHHHHS S
S    H               PS
S HHHSHHHHSHHHHSHHHHS S
SDDDDSbbbbSBBBBS    WWS
SDDDDSssssSBBBBS S SSBS
SDDDDSbbbbSBBBBS S SS#S
SDDDDWssssWDDDDW   SSBS
SSSSSSSSSSSSSSSSSSSSSSS