#######################
#P                W  s#
# # #W# # # #W# # # BW#
#   WsW   D     W     #
# # #W# #W# #W# # B B #
# W       W       W  0#
# #W# # # # # #WB B BW#
#    0W W   W   WW0   #
#W# # #W# # #WB BWB B #
#   W  D 1       D    #
# # # #W# #WB B B B BW#
#bW0  WWW   2 W    3WQ#
#######################