#######################
#b#D D#s#0000000000000#
# #  B# #BBBBBBBBBBBBB#
#PWD  W WDDDDDDDDDDDDD#
# #  B# #BBBBBBBBBBBBB#
#s#D D#b#             #
#########             #
#WWWWW#b#2 2 2 2 2 2 2#
#0W W # #QWWWWWWWWWWWW#
#W  W W W             #
#0W W # # # # # # # # #
#WWWWW#s#  1   1   1  #
#######################