#######################
#XBDP           #0   0#
#XBDHHHHHHHHHHH # # # #
#XBDH           #  3  #
#XBDH ###############W#
#XBDH #X111 BWbs      #
#XBDH ############### #
#XBDH                 #
#XBDHHHHHHHHHHHHHHHHHH#
#XBDDDDDDDDDDDDDDDDDDD#
#WDBBBBBBBBBBBBBBBBBBB#
#QWXXXXXXXXXXXXXXXXXXX#
#######################