#######################
#P  #W #0### #WW  WsBX#
# #B#W D BX#0 W# ######
#W# ## #0###W# #  HDBX#
#W  X# # #1    # ######
###W## DD#W# #0# HHDBX#
#XB WW # #WW   # ######
###B## #0###W### HDBBX#
##  #X D BX# Wb# ####B#
# B #  #0### #B#  WWWs#
##X #B ###   #X#W######
###X#X  W  B #X#  WBCX#
#######################