#######################
#P    #WD0   1W  WW 0D#
#H H#W#W  D WWW   W  W#
#D D# #0    D WW    0D#
#HHH# # WW   0    Q WW#
#   W #WW0  WWWDD    0#
# HH###0          W0W #
#WHB#s# WW WW D   W WW#
#   W W  W       WW  D#
#HHD#b#0 W   1W  D   0#
#BHB#s#D0    WW      W#
#X#X#b#WWW D    D W  0#
#######################