#######################
#D P# bB X#X#0  0  0#X#
#H#   ##B#X # DDsDD #B#
#WXDB  W #B1#   D   DD#
#H######B#  # DD DD #W#
#D   B   ##W#0     0#Q#
#X# #B#DXX  ####W######
#H# # ##X##DH30  2  03#
#   #  ###  #W######D##
#DH HX  W  X# XW  B BX#
#W# ######W##X## XXXX #
#0# W  0B   W X#X  B  #
#######################