#######################
#Ps#s#s#s#s#s#s#s#s#sW#
#s                   b#
## HHHHHHHHHHHHHHHHH ##
#s HB XH    H   1  H b#
## HH HH HH H  X#X H ##
#s H# XH   XH HHHH H b#
## HX  H HHHHXHHXH H ##
#s HX    X    XH   H b#
## HHHHHHHHHHHHHHHHH ##
#s                   b#
#Wb#b#b#b#b#b#b#b#b#bC#
#######################