#######################
#P   s      W     B0WX#
# # #W# # # #W# # # # #
#bW0    W       W     #
# #W# # # #D# #s#W# #W#
#     D    W    D  0  #
# #W# #W# #W# # # #W# #
# W0    W b   B 2 WWs #
# # #D# # #W# #W# #W# #
#   W     2   WQ W 0 W#
#W#W# #W# #W# # # #W#W#
#3WWb 1   D   W0    3D#
#######################