#######################
#P  s   D           WW#
#  b  B       3     #W#
#   s   D             #
#  b  B       2     # #
#   s   D           # #
#  b  B       3       #
#   s   D           # #
#  b  B       2     # #
#   s   D             #
#  b  B       3     #W#
#   s   D           WQ#
#######################