#######################
#P  s     W0         D#
# # # #W# # #W# #W# #W#
# D    WW   WWW   W0  #
# # # # # # #W# # # #b#
#   D0    W     W1  W #
# # #W# # # # # #W# # #
#   WW      W        1#
# # #0# #W# # #D# # #D#
# WsW W  1    DD    W #
#b#W# # #W# # #W# #W# #
#CW     W   W1       2#
#######################