#######################
#######################
#######################
#######################
########P      ########
########  m#   ########
######## ##### ########
########   #C  ########
########      0########
#######################
#######################
#######################
#######################