#######################
#PWW# 0    0    0   0B#
# #Q#  SSSS SSSSSSS Bs#
# ###  S   0   S  0  B#
# Ws#  SSS     S    Bb#
# ###  S       S  0  B#
#W#WW 0    0    0   Bs#
# # #  W WWWW WWWW   B#
# B # 0W WDDW   0W  Bb#
#B#B#  W WDDW WWWW 0 B#
# b W  W0WDDW W     Bs#
#X#X# 1W WWWW WWWW1  B#
#######################