#######################
#Px#D     1 W   D    Q#
# ## #  #        WW   #
# # ######   D      1 #
# #0   W     W     W  #
# #D  1   D      W   D#
#W# W     W    D   0  #
# #    W       ###### #
# #1   W   WW   #D #  #
# #  D     WD    1   D#
# #WWWWWWWWWWWWWWWWWWW#
# D      2 2 2 2 2Wsbs#
#######################