#######################
#P  s           W 0 Ws#
# # # #W# # #W# # # #W#
#bW    WW   WW    W   #
# #W# #W# # #W# # # #W#
#     WWW       WW    #
#W# # #W# # # #W#W# # #
#   W       W0      W0#
#W# # #W# # # # #W# # #
#0      WWW   W       #
#W#W# # #W# # # # # # #
#bW    2    W     WQW2#
#######################