#######################
#P ss           W     #
#      W   D    W 0   #
#b ###             D  #
#b   0  #       #     #
##      #  W         0#
#  0         0 BB 0  W#
#   WW    D           #
#  0           B     W#
#       WQW       0   #
#  W 0    ### ###     #
#       0 #  1  #    W#
#######################