#######################
#s#DDDDDDDDDDDDDDDDDDD#
#W# WWBBBBBBBBBBBBBBBB#
#P  WW0 1 2 0 0 1 2 2 #
#W# WWBBBBBBBBBBBBBBBB#
#b#DDDDDDDDDDDDDDDDDDD#
###WWWWWWWWWWWWWWWWWWW#
#D                   W#
# # # # # # # # # # # #
#    0           0    #
#W# # # # # # # # # #W#
#QW    0   2   0    WW#
#######################