#######################
#P#W0   3 3#W    B    #
# # #B######b#H#H#HHB##
# # #D### ## #0#0#DHD##
#BW W  D W  W#######W##
# # #####B####W## B  ##
### #0   D 0#WCW## # ##
#  W#  1    #2W2#DD####
#W###WWWWWWW#W W#D#DDD#
# BDD    2  #   #DDD#D#
# sDD  0    #W#######D#
# #DD     3 #1 2DDDDDD#
#######################