#######################
#P  b         W       #
#     W          s  W #
# W s            W    #
#    W     W    W    b#
#    0          0     #
#W    W     W      W  #
#       Q         b   #
#   W      b W      W #
#  s      W      W    #
#             0       #
#1   W    s   W  1 W W#
#######################