#######################
#P  Ws       0    W  0#
#W# # #D# #W#D# # # # #
#s      WbWW    W  bW #
#W# #W#b# # # #W# #D# #
#0      W0    WW  W3  #
#W# #W# # # #B#W# #W# #
#WW1W     W     W1   0#
#W# # #W# # #D# # # #W#
#0    b  0  WWWW  W  0#
#D# #W# #W# #1# #W# #D#
#WW 2   QWW2W D1 3W  2#
#######################