#######################
#DDP          #0# W0 X#
#DH HHHHsHHHHb#0# #0###
#DH           #0# #0W #
#DH ###########BH HB# #
#DH H33 W #DBX#DH HD#B#
#DH H33D#3# ###DH HD#C#
#DH H33D#3# #X#DH HD# #
#DH H33D#3# #B###W#####
#DH H33D#W# # #X#  1  #
#DH H  D# #H#H#B#####W#
#DH    D#2W     ssssss#
#######################