#######################
#P                 sWW#
#                   sW#
#                    s#
#              0      #
#                     #
#           3         #
#                     #
#        0            #
#b                   W#
#Wb                 WW#
#WWb               WWC#
#######################