#######################
#######################
#######################
######P          ######
###### #WWW WW # ######
###### WWWW WWWW ######
######     Q    0######
###### WWWW WWWW ######
###### # WW WWW# ######
######     0    0######
#######################
#######################
#######################